###########
#         #
# ##   ## #
# #     # #
#   \^/   #
#   <O>   #
#   /v\   #
# #     # #
# ##   ## #
#         #
###########