##########
#        #
|    X   |
#        #
##########